TTTTTTTTTTTTT
T    P      T
T R         T
T      P    T
T    R      E .
T    P      T
T       R   T
T P    P    T
TTTTTTTTTTTTT